WWWWWWWWWWWWWWW
W W           W
WHW  WWWWW M  W
W    W        W
W        W    W
W        W M  W
W  W    WWWW  W
WWWWWWWWWWWWWWW