WWWWWWWWWWWWWWW
W W           W
WHW  WWWWW    W
W    W        W
W        W    W
W        W    W
W  W    WWWW  W
WWWWWWWWWWWWWWW